****************************************************                            *  
*J     H     P     5      H                       9*                            *  
*      H    -*P   5*******M                   *    *        /=**=\              *  
*=\              --***    H                  **    *       /      \             *  
*  \                              {<=**********          /=        >}           *  
*   \      /=*                  {<=7                   {<            >}         *  
*    \ H  /  *  P 5 / H \     {<=*7                   /                >}       *  
*--****M*=*********=**H**=***=**7             *******=*                  >}     *
*      H              H                                                    =----*
*--    H              H          /=--**=\                                       *
*      H              H         /7*      \                                      *
*--    H   **--       H =\     /7 *      =\                 /=\                -*
*      H --**         H   \   /7  *=\    * \                * *                 *
*--    H   **--       H   *=*=*******-   *  \         **    ***    **         {<*
*      H   *7         H   *********      ****=**--                        *******
*--    H --*-----     H                  *     *                          *     *
*      H   *\         H                --*     *                          *     *
*      H   **=**--         /=*           *     *--                        *--   *
*--    H   *   *          /7 *          /*     *                          *     *
*      H   *   *-      ***7  9\        / *     *                          *   --*
*      H   *   *--     **7    9\      /  *     *--       {<=*=>}          *     *
*=\   /=*  *   ***-----*7   9*7      /   *             {<=      >}        *     *
*  \ /                          /=--=*****         /=**************=\    /*--   *
*   =   S  Z      /=*=\        / *            /=****               **=**=**     *
*                /     \      /  *           /  *                             /=*
****************=       =*  *=****--        Z=***     /=****=\               /  *
*       *                                            /        ==\           /   *
*        \                                          /            ==\       /    *
**********=****************************************=                =*****=******
                                                                                 
