####################################################                            #  
#7           P     5                              9#                            #  
#     #=\    #P   5###M##                          #        /=##=\              #  
#     ###    #-- --###H                            #       /      \             #  
#-----#7     #        H           {<=##########          /=        >}           #  
#          /=#        H         {<=7                   {<            >}         #  
#         /  #  P 5 / H \     {<=#7                   /                >}       #  
#--######=#########=##M##=###=##7             #######=#                  >}     #
#                     H            J                                       =----#
#--                   H          /=--##=\                                       #
#                     H         /7#      \                                      #
#--        ##--       H =\     /7 #      =\                 /=\                -#
#        --##         H  =\   /7  #=\    # \                # #                 #
#--        ##--       H   #=#=#######-   #  \         ##    ###    ##         {<#
#          #7         H   #########      ####=##--                        #######
#--      --#-----     H                  #     #                          #     #
#          #\         H                --#     #                          #     #
#          ##=##--    H    /=#           #     #--                        #--   #
#--        #   #      H   /7 #          /#     #                          #     #
#          #   #-     H###7  9\        / #     #                          #   --#
#          #   #--    H##7    9\      /  #     #--       {<=#=>}          #     #
#=\   /=#  #   ###-----#7   9#7      /   #             {<=      >}        #     #
#  \ /                          /=--=#####         /=##############=\    /#--   #
#   =   S  Z      /=#=\        / #            /=####               ##=##=##     #
#                /     \      /  #           /  #                             /=#
################=       =#  #=####--        Z=###     /=####=\               /  #
#       #                                            /        #=\           /   #
#        \                                          /            #=\       /    #
##########=########################################=                =#####=######
                                                                                 
